1111111111111111111111111111111111
1E000M000000000C00000C000000000001
10100001001000M0101001000000010101
1010000010101010001001000P00010101
10000M000C00C00000F0000000000000C1
1111111111111111111111111111111111